 Арктикль а - це коли щось не конкретизоване, варіюється з an якщо стоїть перед іменником приголосна то 
 вживається a, коли голосна то а, проте іменники що починаються на u(user,university)- ставиться а.

2.Якщо ми згадали якусь річ наприклад a pen, то якщо в цьому реченні або тексті він повториться то перед ним буде 
стояти артикль the, тому що в контексті це уже конкретна річ.



deny використовується тільки з дієсловом
Можемо фактично замінити перед розгалуженням does Ha whether : whether I choosed first or second?

A
    as well as - так добре як 
    admit - визнати
    Approval згода, disapproval - незгода
    adult - дорослий 
    apple itself fell down - яблуко саме по собі впало  
    although- хоча,...
    appealing - привабливий
    acquire a taste for - набути смаку до
    affliction - страждання
    admire - захоплюватися
    admirer - шанувальник 
    auxiliary - допоміжний
    ambient - навколишній
B
    be in control - контролювати
    bring up - виховувати 
    blame - звинувачувати
    beware  - обережно!
C
    соре - впоратися
    could be seen - бачити 
    commiserating - співчуваючи
    condition - хвороба
    conditions - умови
    circumstanses - обставини
    curious - допитливий
    contest  -конкурс
    consume - споживати
    conviction - засудження
    contradiction - протиріччя
D
    discussing - обговорення
    denote  - позначити  (в сенсі помітка)
    despite - всупереч
    devoted - присвячений
    deviate - відхилити
    deriding - висміювання 
    duties - обов'язки
    defunkt - непрацюючий
    domestic - домашній, свійський
    drop dead - впав замертво
Е
    express - висловлювати
    engaging - залучення
    entendre - отримувач
    equestrian - кінний спорт
F
    funds - кошти
    fed up with  - набридло щось робити
    former - колишня
    flawed - не такий
    faucet - підчепити, крюк
G
    guilty - провина
    good-natured - добродушний
    get rid  - позбутися чогось нав'язливого
    grappling - боротися
H
    hitchhiking - автостоп
    have seen - бачив 
    hence - отже
I
    insufficient - недостатній
    insecurity - невпевненість
    in order to - щоб, 
    it is so clear - це і так зрозyміло
    imply - мати на увазі
    inspire - надихати
    indulging - потакать
    intend - мати намір
J
    jester - блазень
K
    kind - дружелюбний 
L 
    literate - грамотний
    limitations  - обмеження
    leather clad - одягнений в шкіряний одяг
    lasting - тривалий
M
    mysterious - загадковий
    make ends meet - звести кінці з кінцями
    make the most of - взяти найбільше з 
N
    notice - помітити гарне волосся 
O
    otherwise - інакше
    over the past few years - за останні кілька років
    operate a till - керувати касою
P
    perceiving  - сприйняття тепла
    pay attention - звернути увагу.Саме pay !!!
    pay attention to 
    prove - довести
    plead someone - благати
    possess a good manners - володіти хорошими манерами
    preferred - бажаний  
    parole - "Условка"
    premises  - приміщення
    persuade - переконувати
    proceeding - процес розгляду
    pursuit - погоня
    parcel - посилка
R
    remedy it - виправити це
    regardless - в незалежності від того
    represents - представляє (чиїсь інтереси) 
    reservation - бронювання
    retain - зафіксувати
    reliability - надійність
    revelation - одкровення
    redemption -  відкуп
    rotting - гниитя
    rotten - гнилий
S
    solemn - урочистий 
    Simultaneously - одночасно
    spite - на зло 
    straightaway - негайно(син. immidiately)
    subordinates - підлеглі
    setting off - відправлятись
    steady - стійкий
T
    those - ті
    that - той
    these - ці
    this - цей
    tile - плитка
    take advantage of you - скористатися Вами 
    tend - прагнути
    tension - напруга(моральна)
    treaty - договір
    tribes - племена
    transparent - прозорий
U
     Unkind - недружелюбно 
V
     vow - обітниця, обіцянка релігійного характеру
W
    would you mind CLOSING window - ввічливо попросити закрити вікно.
    wage  - стабільний дохід(син. steady income) 
    work in shifts - робота по змінам
    workload - робоче навантаження
    whine - нити
    weathered - вивітрене,обвітрене
